ARE	AA R
ARE(2)	ER
COMPUTER	K AH M P Y UW T ER
FACE	F EY S
GO	G OW
HOW	HH AW
HUMAN	HH Y UW M AH N
HUMAN(2)	Y UW M AH N
IS	IH Z
OFF	AO F
ON	AA N
ON(2)	AO N
RECOGNIZE	R EH K AH G N AY Z
SCREEN	S K R IY N
THE	DH AH
THE(2)	DH IY
THERE	DH EH R
TURN	T ER N
YOU	Y UW
YOUTUBE	Y UW T UW B
